1111111111111111111111111111
1E0010C0000000CC00000000C001
10001110000000000000C0000001
1P000000000C0000C00000000001
10000000000CC000000000000001
100C000000CCCC00000000000001
1111111111111111111111111111