111111111111111111111111111111111111111
1000000P000000000000000000C00000000E001
1000000000000000C00000000000000C0000001
11111111111111111111111111111111111111