111111111111111111111111111111111111111
1000E000000000000000000010000000000E001
10000000000000000000000010C000000000001
1000000000000000000000001C0C00000C00001
100C0C000000000000000000111111000000001
10CCCC000000000000000000000000000000001
1111111100000000E0000000000000000000001
100000000000000000000000000000C00000001
100000000000000000111110000000000000001
1000000000C0000000111000000000000000001
1C00000000000000001110000000CP0000000C1
100C000000000111111111111000000000000C1
10C00E000000000000000000000000000000CE1
111111111111111111111111111111111111111