1111111
100i0P1
1C0E001
1111111