111111111111111111111111111111111111111
10000000000000000000000010000000000E001
100000000000000000000000100000000000001
1000000P0000000000000000100000000000001
100000000000000000000000111111000000001
100000000000000000000000000000000000001
1111111100000000E0000000000000000000001
100000000000000000000000000000000000001
100000000000000000111110000000000000001
1000000000C0000000000000000000000000001
1000000000000000000000000000C0000000001
100000000000011111111111100000000000001
100000000000000000000000000000000000001
111111111111111111111111111111111111111