1111111111
1E00100001
1000111001
1P00001001
1000000001
1000000001
1000000001
1000000001
1E00000001
1111111111