111111111111111111111111111111111111111111111111111111111111111111111111111111111111111111111111111111111111111111111111111111111111111111111111111111111111111111111111111111111111111111111111
1000000P000000000000000000000000000000C000000000000000000000000000000000000000000000000000000000000C00000000000000000000000000000000000000000000000000000000000000000000000000000000000000000001
100E000000000000C00000010000000000000000000C00000000000000000000000000000000000000000000000000000C00000000000000000000000000000000000000000000000000000C0000000000000000000000000000000000000E01
111111111111111111111111111111111111111111111111111111111111111111111111111111111111111111111111111111111111111111111111111111111111111111111111111111111111111111111111111111111111111111111111